		江湖风云游戏的命令分为下列几类：

[玩家命令]
  help(帮助)		exit|quit(退出)		passwd(修改密码)
  save(保存)		nick(取昵称)		score(查看属性)
  hp(查看状态)		id(查看物品英文名)	inventory(i)(看身上的东西)
  set(设置环境变量)	unset(取消环境变量)	time(当前时间)
  uptime(游戏执行时间)	version(游戏版本号)	wimpy(逃跑系数)
  alias(简化命令)	suicide(自杀)		semote(查表情动词)
  wizlist(查看巫师名单)	sleep(睡觉)		title(自己的名号)
[战斗用指令]
  fight(切磋)		kill(杀)		hit(攻击)
  persuade(劝架)	ansuan(暗算)		touxi(偷袭)
  surrender(投降)  
[沟通用指令]
  ask(问)		chat(闲聊)		finger(查询)
  tell(告诉)		reply(回答)		say(说)
  tune(关闭交谈频道)	whisper(耳语)		who(查在线玩家)
  follow(跟随)		vote(检举)		emote(表情)
  ct(夫妻对话)		describe(设定对自己的描述) to(多行输送信息)
[武功]
  learn(学武功)		skills(查看技能)	abandon(放弃某样武功)
  enforce(用内力)	exercise(练内力)	exert(运用内功)
  respitate(练法力)	enable(激活特殊技能)	prepare(激发组合武功)
  practice(练武功)	perform(使用外功)	check(打听别人的武功)	
  wear(穿着)		remove(脱)		wield(装备武器)
  unwield(放下武器)	study(读书)		teach(教)
[门派]
  apprentice|bai(拜师)	expell(开除)		recruit(收徒) 
[对特定对象使用的指令]
  open(打开)		close(关闭)		get(拣起)
  give(给)		drop(丢弃)		look(看)
  follow(跟随)		tear(撕布条)		bandage(包扎)
  eat(吃)		drink(喝)		fill(装水)
  buy(买)		sell(卖)		list(看商品列表)
  beg(乞讨)		steal(偷)
[巫师命令]

请参照 help wizcmds

